19
22
139
0 0 0 0 21 2 2 2 20 0 21 2 2 2 20 0 0 0 0
0 0 0 0 3 1 1 1 22 2 23 1 1 1 3 0 0 0 0
0 0 0 0 3 1 10 1 1 1 1 1 10 1 3 0 0 0 0
2 2 2 2 23 1 19 9 1 10 1 8 18 1 22 2 2 2 2
0 0 1 1 1 -5 3 1 1 3 1 1 3 -5 1 1 1 0 0
21 9 1 8 2 2 18 1 8 25 9 1 19 2 2 9 1 8 20
3 1 1 1 1 1 3 1 1 3 1 1 3 1 1 1 1 1 3
3 1 8 2 20 1 22 9 1 11 1 8 23 1 21 2 9 1 3
3 1 1 1 3 1 0 0 0 0 0 0 0 1 3 1 1 1 3
22 2 20 1 22 9 0 21 2 24 2 20 0 8 23 1 21 2 23
0 1 11 1 1 1 0 3 0 0 0 3 0 1 1 1 11 1 0
10 1 1 1 21 9 0 22 2 2 2 23 0 8 20 1 1 1 10
3 1 10 1 3 1 0 0 0 0 0 0 0 1 3 1 10 1 3
11 1 3 1 3 1 8 2 2 16 2 2 9 1 3 1 3 1 11
0 1 3 1 3 1 1 1 1 3 1 1 1 1 3 1 3 1 0
21 2 23 1 22 2 2 9 1 11 1 8 2 2 23 1 22 2 20
3 1 1 -5 1 1 1 1 1 0 1 1 1 1 1 -5 1 1 3
3 1 10 1 21 2 2 2 2 2 2 2 2 2 20 1 10 1 3
3 1 3 1 3 0 0 0 0 0 0 0 0 0 3 1 3 1 3
3 1 11 1 3 0 0 0 0 0 0 0 0 0 3 1 11 1 3
3 1 1 1 3 0 0 0 0 0 0 0 0 0 3 1 1 1 3
22 2 2 2 23 0 0 0 0 0 0 0 0 0 22 2 2 2 23