19
22
157
21 2 2 2 2 2 2 2 2 16 2 2 2 2 2 2 2 2 20
3 -5 1 1 1 1 1 1 1 3 1 1 1 1 1 1 1 -5 3
3 1 4 5 1 4 12 5 1 3 1 4 12 5 1 4 5 1 3
3 1 6 7 1 6 13 7 1 11 1 6 13 7 1 6 7 1 3
3 1 1 1 1 1 1 1 1 1 1 1 1 1 1 1 1 1 3
3 1 8 9 1 10 1 8 2 16 2 9 1 10 1 8 9 1 3
3 1 1 1 1 3 1 1 1 3 1 1 1 3 1 1 1 1 3
22 2 2 20 1 19 2 9 0 11 0 8 2 18 1 21 2 2 23
0 0 0 3 1 3 0 0 0 0 0 0 0 3 1 3 0 0 0
2 2 2 23 1 11 0 21 9 24 8 20 0 11 1 22 2 2 2
0 0 0 0 1 0 0 3 0 0 0 3 0 0 1 0 0 0 0
2 2 2 20 1 10 0 22 2 2 2 23 0 10 1 21 2 2 2
0 0 0 3 1 3 0 0 0 0 0 0 0 3 1 3 0 0 0
21 2 2 23 1 11 0 8 2 16 2 9 0 11 1 22 2 2 20
3 1 1 1 1 1 1 1 1 3 1 1 1 1 1 1 1 1 3
3 1 8 20 1 8 2 9 1 11 1 8 2 9 1 21 9 1 3
3 1 1 3 1 1 1 1 1 1 1 1 1 1 1 3 1 1 3
19 9 1 11 1 10 1 8 2 16 2 9 1 10 1 11 1 8 18
3 1 1 1 1 3 1 1 1 3 1 1 1 3 1 1 1 1 3
3 1 8 2 2 17 2 9 1 11 1 8 2 17 2 2 9 1 3
3 -5 1 1 1 1 1 1 1 1 1 1 1 1 1 1 1 -5 3
22 2 2 2 2 2 2 2 2 2 2 2 2 2 2 2 2 2 23